You got the message from Roy this morning:  "Something's gone horribly wrong at the Hideout!" he said.  "We can't find the skull anywhere!"  Then he finished the message hastily:  "Hold on, Ceej is getting attacked by a grue."  And then ...nothing.

So here you are at the Hideout Theatre, determined to get to the bottom of what's going on.

The Hideout Theatre Adventures: Quest for the Secret Skull
Thrills and adventure in an Austin-area improv theatre! by Peter Rogers et al
Release 1 / Serial number 120125 / Inform 7 build 6G60 (I6/v6.32 lib 6/12N) SD
Enter "HELP" at any time for information about how to play this game.

Hideout Entryway
To your east stands the entrance to the Hideout Theatre & Coffeehouse.  Under normal circumstances, this would be a bright, cheery street scene, with happy passers-by going about their business in the middle of downtown Austin.  But everything seems a little... off.  The sky looks odd.  An occasional chill creeps up your spine.  And you sense that something is deeply, deeply Not Right.

There is a ticket at your feet.

You can also see Brad here.

>I
You are carrying nothing.

>x stub
You see nothing special about the paper stub.

>get it
Taken.

>x it
You see nothing special about the paper stub.

>read it
You see nothing special about the paper stub.

>x brad
Don't eye him too closely -- he'll cut you.

* * *

>kiss brad
You can only do that to something animate.

* * *

>x stub
This is a ticket to see an Improvised Text Adventure at the Hideout Theatre!

>get it
Taken.

>give it to brad
You can only do that to something animate.

>x brad
Don't eye him too closely -- he'll cut you.

* * *

>get stub
Taken.

>give stub to brad
Brad doesn't seem interested.

>kiss brad
Keep your mind on the game.

>kiss him
Keep your mind on the game.

>enter the theater
You can't see any such thing.

* * *

>get stub
Taken.

>look at stub
This is a ticket to see an Improvised Text Adventure at the Hideout Theatre!

>say hi to brad
There is no reply.

>look brad
Don't eye him too closely -- he'll cut you.

>verbose
The Hideout is now in its "verbose" mode, which always gives long descriptions of locations (even if you've been there before).

>l
7th-and-Congress
You are in downtown Austin, TX. To the east is The Hideout Theatre & Coffeehouse.

You can see Brad here.

>e
Hideout Coffeehouse
A long counter displays many exotic coffees and pastries. Also there are bagel dogs. A surly group of cartoonists sketch frantically in a corner. To the east is a stairwell.

You can see Carl here.

>look carl
Carl wears a wistful smile and khaki shorts.

>say hi to carl
There is no reply.

>get bagel dogs
You can't see any such thing.

>get pastries
You can't see any such thing.

>get coffees
You can't see any such thing.

>get dogs
You can't see any such thing.

>look dogs
You can't see any such thing.

>l
Hideout Coffeehouse
A long counter displays many exotic coffees and pastries. Also there are bagel dogs. A surly group of cartoonists sketch frantically in a corner. To the east is a stairwell.

You can see Carl here.

>e
You can't go that way.

>up
Stairway
You find yourself on a narrow stairway with a mural painted along one wall.

>u
Foyer
This is a small foyer at the top of the stairs.  Roy sits at a small desk, holding a fancy hole punch.  To the east is the theater space.  To the west is the green room.  To the south is a small bathroom.  To the north is a locked door.

You can see an office door and a man named Roy here.

>look roy
A crazed hobo, reeking of home-stilled hooch, Roy eyes you with the wary conviction that you might be the source of the voices in his head.

>get all
silver key: That seems to belong to the man named Roy.

>ask roy for key
The man named Roy has better things to do.

>w
Green Room

>l
Green Room

* * *

>look
Hideout

* * *

>go hideout
You can't see any such thing.

>go hideout coffeehouse
You can't see any such thing.

>go east
Hideout Coffeehouse
A long counter displays many exotic coffees and pastries. Also there are bagel dogs. A surly group of cartoonists sketch frantically in a corner.

You can see Carl here.

>look carl
Carl wears a wistful smile and khaki shorts.

* * *

>x brad
Brad Hawkins is a bald, bearded, bespectacled man, neatly dressed and regarding the sky above with some trepidation.

>x stub
You can't see any such thing.

>l
Hideout
Before you stands the Hideout Theatre, a coffeeshop/improv theater.

There is a paper stub at your feet.

You can also see a man named Brad here.

* * *

>x brad
Brad Hawkins is a bald, bearded, bespectacled man, neatly dressed and regarding the sky above with some trepidation.

>kiss him
Brad evades your clumsy advances.

>give him the stub
(first taking the paper stub)
Brad doesn't seem interested.

* * *

>kiss him
Brad evades your clumsy advances.

>get the stub
Taken.

>read it
This is a ticket to see an Improvised Text Adventure at the Hideout Theatre!

>give it to him
Brad doesn't seem interested.

>enter the theater
You can't see any such thing.

* * *

>kiss him
Brad evades your clumsy advances.

>in
You can't go that way.

>e
Hideout Coffeehouse
A long counter displays many exotic coffees and pastries. Also there are bagel dogs. A surly group of cartoonists sketch frantically in a corner. To the east is a stairwell.

You can see Carl here.

>x carl
Carl wears a wistful smile and khaki shorts.

>x bagel dogs
You can't see any such thing.

>x long counter
You can't see any such thing.

>x counter
You can't see any such thing.

* * *

>kiss him
Brad evades your clumsy advances.

>get stub
Taken.

>give it to brad
Brad says, "No thanks, I've already got a ticket."

>x brad
Don't eye him too closely -- he'll cut you.

>in
You can't go that way.

>east
Hideout Coffeehouse
A long counter displays many exotic coffees and pastries. Also there are bagel dogs. A surly group of cartoonists sketch frantically in a corner. The theater is above the coffeehouse, accessible via a stairway.

You can see Carl here.

* * *

>x brad
Brad Hawkins is a bald, bearded, bespectacled man, neatly dressed and regarding the sky above with some trepidation.

>ask brad about himself
Brad Hawkins?  Some say he was a drifter who came from nowhere and was headed for oblivion.  Some say he was a myth so often told and retold, he became real.  I prefer to think of him as an improvisor with an unhealthy addiction to breakfast tacos."

>ask brad about Brad Hawkins
Brad Hawkins?  Some say he was a drifter who came from nowhere and was headed for oblivion.  Some say he was a myth so often told and retold, he became real.  I prefer to think of him as an improvisor with an unhealthy addiction to breakfast tacos."

* * *

>take paper
Taken.

>e
Hideout Coffeehouse
A long counter displays many exotic coffees and pastries. Also there are bagel dogs. A surly group of cartoonists sketch frantically in a corner. To the east is a stairwell.

You can see Carl here.

>go up
Stairway
You find yourself on a narrow stairway with a mural painted along one wall.

>go up
Foyer
This is a small foyer at the top of the stairs.  Roy sits at a small desk, holding a fancy hole punch.  To the east is the theater space.  To the west is the green room.  To the south is a small bathroom.  To the north is a locked door.

You can see an office door and a man named Roy here.

>say hi to roy
There is no reply.

>look roy
A crazed hobo, reeking of home-stilled hooch, Roy eyes you with the wary conviction that you might be the source of the voices in his head.

>w
Green Room

>look
Green Room

>e
Foyer
This is a small foyer at the top of the stairs.  Roy sits at a small desk, holding a fancy hole punch.  To the east is the theater space.  To the west is the green room.  To the south is a small bathroom.  To the north is a locked door.

You can see an office door and a man named Roy here.

>take hole punch
You can't see any such thing.

>n
(first opening the office door)
It seems to be locked.

>unlock door
(with the paper stub)
That doesn't seem to fit the lock.

>s
Small Bathroom
You can see a time machine here.

>turn on time machine
You switch the time machine on.

* * *

>get brad
I don't suppose Brad would care for that.

* * *

>hi brad
That's not a verb I recognise.

>tell brad hello
I didn't understand that sentence.

>say hello to brad
There is no reply.

>get stub
Taken.

>x it
This is a ticket to see an Improvised Text Adventure at the Hideout Theatre!

>e
Hideout Coffeehouse
This is the coffeehouse.

You can see Carl here.

>x carl
You see nothing special about Carl.

>x myself
As good-looking as ever.

>shout
I didn't understand that sentence.

>xyzzy
That's not a verb I recognise.

>hello sailor
That's not a verb I recognise.

* * *

>e
Hideout Coffeehouse
A long counter displays many exotic coffees and pastries. Also there are bagel dogs. A surly group of cartoonists sketch frantically in a corner. The theater is above the coffeehouse, accessible via a stairway.

You can see Carl here.

>w
7th & Congress
You are in downtown Austin, TX. To the east is The Hideout Theatre & Coffeehouse.

There is a paper stub at your feet.

You can also see Brad here.

>e
Hideout Coffeehouse
This is the coffeehouse.

You can see Carl here.

* * *

>e
Hideout Coffeehouse
A long counter displays many exotic coffees and pastries. Also there are bagel dogs. A surly group of cartoonists sketch frantically in a corner. The theater is above the coffeehouse, accessible via a stairway.

You can see Carl here.

>u
Stairway
You are standing on a long, steep set of stairs with two landings. The walls are dusty, with a few old picture-frame nails ihammered into them.  You see a colorful mural painted along one wall.  At the top of the stairs you see a small room with a ticket table, and you can go downstairs to the coffee shop.

>u
Foyer
This is a small, L-shaped foyer at the top of the stairs.  Kareem sits at a small desk beneath a pretty chandelier, holding a fancy hole punch.  There are doors to the north, south, east, and west, a steep stairway leading down, and a ladder leading up.

You can see an office door and a man named Kareem here.

>w
Kareem blocks your path.  "Can't get in without a ticket!" he shouts.

>e
Green Room
This is a large, spacious, well-lit room with hardwood floors.  There is a door up a short stairway to the east, a door to the west, and a door in the northeast corner of the room. There is a bell here.

There are two sets of chairs -- one red, and one black.  The red ones have a sign:  "For Shows Only!"

You can also see a bell here.

>get bell
Taken.

>x it
You see nothing special about the bell.